000000000000000000000000
000000000000000000000000
000000000000000000000000
111111111110111111111111
000000000010100000000000
000000000010100000000000
111111111110111111111111
000000000009000000000000
000000000000000000000000
111111111111111111111110
000000000000000000000000
000000000000000000000000
000000000000000000000000
000000000000000000000000
000000000000000000000000
000000000000000000000000
000000000000000000000000
000000000000000000000000
