000000000000000000000000
111111111111111111111110
000000000000000000000000
011111111111111111111111
000000000000000000000000
111111111111111111111110
000000000000000000000000
011111111111111111111111
000000000000000000000000
111111111111111111111110
000000000000000000000000
000000000090000000000000
000000000000000000000000
000000000000000000000000
000000000000000000000000
000000000000000000000000
000000000000000000000000
000000000000000000000000
